0 0 0 0 0 5 5 5 5 0 0 0 0
0 0 0 5 5 5 5 5 5 0 0 0 0
0 0 5 8 8 8 8 8 8 5 5 5 0
0 0 5 8 10 10 10 10 10 10 0 5 0
0 0 5 10 10 11 11 11 11 10 10 0 0
5 5 8 10 11 12 12 12 12 11 10 8 5
5 5 8 10 11 12 12 12 12 11 10 8 5
5 5 8 10 11 12 12 12 12 11 10 8 5
5 5 8 10 11 12 12 12 12 11 10 8 5
5 5 8 10 11 12 12 12 12 11 10 8 5
5 8 10 10 11 11 11 11 10 10 0 0
0 5 8 10 10 10 10 10 10 0 5 0
0 5 8 8 8 8 8 8 0 0 5 0
0 0 5 5 5 5 5 5 5 5 0 0
0 0 0 0 5 5 5 5 0 0 0 0
